PROJECT="fossology"
PROJECTUSER="fossy"
PROJECTGROUP="fossy"
DESTDIR=""
PREFIX="/usr/local"
BINDIR="/usr/local/bin"
SBINDIR="/usr/local/sbin"
SYSCONFDIR="/usr/local/etc/fossology"
INITDIR="/etc"
LIBDIR="/usr/local/lib"
INCLUDEDIR="/usr/local/include"
LIBEXECDIR="/usr/local/lib/fossology"
DATAROOTDIR="/usr/local/share"
MODDIR="/usr/local/share/fossology"
LOCALSTATEDIR="/var/local"
LOGDIR="/var/log/fossology"
PROJECTSTATEDIR="/var/local/lib/fossology"
CACHEDIR="/var/local/cache/fossology"
MANDIR="/usr/local/share/man"
MAN1DIR="/usr/local/share/man/man1"
DOCDIR="/usr/local/share/doc/fossology"
WEBDIR="/usr/local/share/fossology/www"
PHPDIR="/usr/local/share/fossology/php"
VERSION="3.10.0.186-rc1"
COMMIT_HASH="2bfd8d"
TWIG_CACHE="<parameter key="cache" type="string">/var/local/cache/fossology</parameter>"
APACHE_CTL="/usr/sbin/apachectl"
APACHE2_SITE_DIR="/etc/apache2/sites-available"
APACHE2_EN_SITE="/usr/sbin/a2ensite"
HTTPD_SITE_DIR="/etc/httpd/conf.d"
REPODIR="/srv/fossology/repository"
